AUS	aus
AUB	aub
AUC	auc
AUD	aud
AU1	au1
TWN	ct
CHD	cd
GGD	gg
GPL	gp
HKS	st
DBN	IG2
JNN	sp9
LSE	ls
LQN	la
IVN	pb2
IVM	pb1
RED	rp
RUD	rui
SAD	sa
ETE	scd
JDM	op1
JDN	op2
TAM	tam
MXS	lap